#####################
#E.....O............#
#.###.###.#####.##..#
#..O.....E....O.....#
#.#######.###.#####.#
#.......E.#.......P.#
#.########.#######..#
#.....O....#..E.....#
#..######.###.#####.#
#.......P.......E...#
#####################


