#####################
#E........p........E#
#.#####.#####.#####.#
#.#...#.#...#.#...#.#
#.#.#.#.#.#.#.#.#.#.#
#.#.#...#.#...#.#.#.#
#.#.#####.#####.#.#.#
#.#...p.........#.P.#
#.#####.#####.#####.#
#.....#.#...#.#...#.#
#####.#.#.#.#.#.#.#.#
#..p..#.#.#...#.#.#.#
#.#####.#.#####.#.#.#
#.........O.......E.#
#####################
