######################
#E...................#
#.#####.#####.#####..#
#.#...#.#...#.#...#..#
#.#.#.#.#.#.#.#.#.#..#
#.#.#...#.#...#.#.#..#
#.#.#####.#####.#.#..#
#.#......p...........#
#.###.#.#####.##.##..#
#.###.#.#####p##.##..#
#.###.#.#####.##.##..#
#.###.#.#####.##.##..#
#.###.#.#####.##.##..#
#........p......p....#
######################